v2.0 raw
4c400008
4c800004
7c440040
74c40040
010c8000
90000000
